1111111111111
1001C00100001
1000000000011
1P0010E100C01
1111111111111