1111111111111
1001C001000C1
1000000110011
1P0010E100001
1111111111111