1111111111111
1001C00100001
1000000110011
1P0010E100001
1111111111111