11111111111
1001C001001
10000000011
10000000011
10000000011
10000000011
10000000011
10000000011
10000000011
10000000011
10000000011
10000000011
10000000011
10000000011
10000000011
10000000011
10000000011
10000000011
10000000011
10000000011
10000000011
10000000011
10000000011
10000000011
10000000011
10000000011
10000000011
10000000011
10000000011
10000000011
100000C0011
10000000011
10000000011
10000000011
10000000011
10000000011
10000000011
10000000011
10000000011
10000000011
10000000011
10000000011
10000000011
10000000011
10000000011
10000000011
10000000011
10000000011
10000000011
10000000011
10000000011
10000000011
10000000011
10000000011
10000000011
10000000011
10000000011
10000000011
10000000011
10000000011
10000000011
10000000011
10000000011
10000000011
10000000011
10000000011
10000000011
10000000011
10000000011
10000000011
10000000011
10000000011
10000000011
10000000011
10000000011
10000000011
10000000011
10000000011
10000000011
10000000011
10000000011
10000000011
10000000011
10000000011
10000000011
1001C001001
10000000011
10000000011
10000000011
10000000011
10000000011
10000000011
10000000011
10000000011
10000000011
10000000011
10000000011
10000000011
10000000011
10000000011
10000000011
10000000011
10000000011
10000000011
10000000011
10000000011
10000000011
10000000011
10000000011
10000000011
10000000011
10000000011
10000000011
10000000011
100000C0011
10000000011
10000000011
10000000011
10000000011
10000000011
10000000011
10000000011
10000000011
10000000011
10000000011
10000000011
10000000011
10000000011
10000000011
10000000011
10000000011
10000000011
10000000011
10000000011
10000000011
10000000011
10000000011
10000000011
10000000011
10000000011
10000000011
10000000011
10000000011
10000000011
10000000011
10000000011
10000000011
10000000011
10000000011
10000000011
10000000011
10000000011
10000000011
10000000011
10000000011
10000000011
10000000011
10000000011
10000000011
10000000011
10000000011
10000000011
10000000011
10000000011
10000000011
10000000011
10000000011
10000000011
1001C001001
10000000011
10000000011
10000000011
10000000011
10000000011
10000000011
10000000011
10000000011
10000000011
10000000011
10000000011
10000000011
10000000011
10000000011
10000000011
10000000011
10000000011
10000000011
10000000011
10000000011
10000000011
10000000011
10000000011
10000000011
10000000011
10000000011
10000000011
10000000011
100000C0011
10000000011
10000000011
10000000011
10000000011
10000000011
10000000011
10000000011
10000000011
10000000011
10000000011
10000000011
10000000011
10000000011
10000000011
10000000011
10000000011
10000000011
10000000011
10000000011
10000000011
10000000011
10000000011
10000000011
10000000011
10000000011
10000000011
10000000011
10000000011
10000000011
10000000011
10000000011
10000000011
10000000011
10000000011
10000000011
10000000011
10000000011
10000000011
10000000011
10000000011
10000000011
10000000011
10000000011
10000000011
10000000011
10000000011
10000000011
10000000011
10000000011
10000000011
10000000011
10000000011
10000000011
1001C001001
10000000011
10000000011
10000000011
10000000011
10000000011
10000000011
10000000011
10000000011
10000000011
10000000011
10000000011
10000000011
10000000011
10000000011
10000000011
10000000011
10000000011
10000000011
10000000011
10000000011
10000000011
10000000011
10000000011
10000000011
10000000011
10000000011
10000000011
10000000011
100000C0011
10000000011
10000000011
10000000011
10000000011
10000000011
10000000011
10000000011
10000000011
10000000011
10000000011
10000000011
10000000011
10000000011
10000000011
10000000011
10000000011
10000000011
10000000011
10000000011
10000000011
10000000011
10000000011
10000000011
10000000011
10000000011
10000000011
10000000011
10000000011
10000000011
10000000011
10000000011
10000000011
10000000011
10000000011
10000000011
10000000011
10000000011
10000000011
10000000011
10000000011
10000000011
10000000011
10000000011
10000000011
10000000011
10000000011
10000000011
10000000011
10000000011
10000000011
10000000011
10000000011
10000000011
10000000011
10000000011
10000000011
1P0010E10C1
11111111111