11111111111111111111111111111111111111111111111111
1001C00100000000000C011100000000000000000100000001
1000000001000000000C00000000CCCCCCC0000CCCC0000001
1P0010E10C000000000C000000000000000000000000000001
11111111111111111111111111111111111111111111111111