111111111111
1001C0010011
100PE000011
10C010010C1
10000000011
10001101011
10001001011
10001111011
11111111111